5 1 1 1 1 1 1 1 1 1 1 1 1 13 14 1 1 1 1 1 1 1 1 1 1 1 1 8
2 26 26 26 26 26 26 26 26 26 26 26 26 24 22 26 26 26 26 26 26 26 26 26 26 26 26 4
2 26 9 21 21 12 26 9 21 21 21 12 26 24 22 26 9 21 21 21 12 26 9 21 21 12 26 4
2 26 24 25 25 24 26 24 25 25 25 24 26 24 22 26 24 25 25 25 24 26 24 25 25 24 26 4
2 26 10 21 21 11 26 10 21 21 21 11 26 10 11 26 10 21 21 21 11 26 10 21 21 11 26 4
2 26 26 26 26 26 26 26 26 26 26 26 26 26 26 26 26 26 26 26 26 26 26 26 26 26 26 4
2 26 9 21 21 12 26 9 12 26 9 21 21 21 21 21 21 12 26 9 12 26 9 21 21 12 26 4
2 26 10 21 21 11 26 24 24 26 10 21 21 12 9 21 21 11 26 24 24 26 10 21 21 11 26 4
2 26 26 26 26 26 26 24 24 26 26 26 26 24 24 26 26 26 26 24 24 26 26 26 26 26 26 4
6 3 3 3 3 12 26 24 10 21 21 12 26 24 24 26 9 21 21 11 24 26 9 3 3 3 3 7
25 25 25 25 25 2 26 24 9 21 21 11 26 10 11 26 10 21 21 12 24 26 4 25 25 25 25 25
25 25 25 25 25 2 26 24 24 26 26 26 26 26 26 26 26 26 26 24 24 26 4 25 25 25 25 25
25 25 25 25 25 2 26 24 24 26 9 3 3 3 3 3 3 12 26 24 24 26 4 25 25 25 25 25
1 1 1 1 1 11 26 24 24 26 4 25 25 25 25 25 25 2 26 24 24 26 10 1 1 1 1 1
26 26 26 26 26 26 26 24 24 26 4 25 25 25 25 25 25 2 26 24 24 26 26 26 26 26 26 26
3 3 3 3 3 12 26 24 24 26 4 25 25 25 25 25 25 2 26 24 24 26 9 3 3 3 3 3
25 25 25 25 25 2 26 24 24 26 10 1 1 1 1 1 1 11 26 24 24 26 4 25 25 25 25 25
25 25 25 25 25 2 26 24 24 26 26 26 26 26 26 26 26 26 26 24 24 26 4 25 25 25 25 25
25 25 25 25 25 2 26 24 24 26 9 21 21 21 21 21 21 12 26 24 24 26 4 25 25 25 25 25
5 1 1 1 1 11 26 10 11 26 10 21 21 12 9 21 21 11 26 10 11 26 10 1 1 1 1 8
2 26 26 26 26 26 26 26 26 26 26 26 26 24 24 26 26 26 26 26 26 26 26 26 26 26 26 4
2 26 9 21 21 12 26 9 21 21 21 12 26 24 24 26 9 21 21 21 12 26 9 21 21 12 26 4
2 26 10 21 12 24 26 10 21 21 21 11 26 10 11 26 10 21 21 21 11 26 24 9 21 11 26 4
2 26 26 26 24 24 26 26 26 26 26 26 26 26 26 26 26 26 26 26 26 26 24 24 26 26 26 4
19 23 12 26 24 24 26 9 12 26 9 21 21 21 21 21 21 12 26 9 12 26 24 24 26 9 23 15
20 21 11 26 10 11 26 24 24 26 10 21 21 12 9 21 21 11 26 24 24 26 10 11 26 10 21 16
2 26 26 26 26 26 26 24 24 26 26 26 26 24 22 26 26 26 26 24 24 26 26 26 26 26 26 4
2 26 9 21 21 21 21 11 10 21 21 12 26 24 24 26 9 21 21 11 10 21 21 21 21 12 26 4
2 26 10 21 21 21 21 21 21 21 21 11 26 10 11 26 10 21 21 21 21 21 21 21 21 11 26 4
2 26 26 26 26 26 26 26 26 26 26 26 26 26 26 26 26 26 26 26 26 26 26 26 26 26 26 4
6 3 3 3 3 3 3 3 3 3 3 3 3 3 3 3 3 3 3 3 3 3 3 3 3 3 3 7
